11111
11CP1
1E001
11111
11111
11111
11111
