11111111111111
1P00C0C1100001
10010C0E000001
10010000100001
11111111111111